1111111111111111111111111111111111111111111111111111111111111111111111111111111111111111111111111111
1..................1...................1...................1...................1...................1
1..................1...................1...................1...................1...................1
1..................1...................1...................1...................1...................1
1..................1...................1...................1...................1...................1
1..................1...................1...................1...................1...................1
1..................1...................1...................1...................1...................1
1..................1...................1...................1...................1...................1
1..................1...................1...................1...................1...................1
1..................1...................1...................1...................1...................1
1..................1...................1...................1...................1...................1
1..................1...................1...................1...................1...................1
1..................1...................1...................1...................1...................1
1..................1...................1...................1...................1...................1
1..................1...................1...................1...................1...................1
1..................1...................1...................1...................1...................1
1..................1...................1...................1...................1...................1
1..................1...................1...................1...................1...................1
1..................1...................1...................1...................1...................1
11....11111111111111111111111....1111111111111111....111111111111....11111111111111111111111....1111
1..................................................................................................1
1..................................................................................................1
1..................................................................................................1
1..................................................................................................1
1..................................................................................................1
1..................................................................................................1
1.......1111111111111111...........................................................................1
1.......1..........................................................................................1
1.......1..........................................................................................1
1.......1..........................................................................................1
1.......1..........................................................................................1
1.......1..........................................................................................1
1.......1..........................................................................................1
1.......1..........................................................................................1
1.......1..........................................................................................1
1.......1..........................................................................................1
1.......1..........................................................................................1
1.......1111111111111111...........................................................................1
1.......1..........................................................................................1
1.......1..........................................................................................1
1.......1..........................................................................................1
1.......1..........................................................................................1
1.......1..........................................................................................1
1.......1..........................................................................................1
1.......1..........................................................................................1
1.......1..........................................................................................1
1.......1..........................................................................................1
1.......1..........................................................................................1
1.......1111111111111111...........................................................................1
1.......1..........................................................................................1
1.......1..........................................................................................1
1.......1..........................................................................................1
1.......1..........................................................................................1
1.......1..........................................................................................1
1.......1..........................................................................................1
1.......1..........................................................................................1
1.......1..........................................................................................1
1.......1..........................................................................................1
1.......1..........................................................................................1
1111111111111111111111111111111111111111111111111111111111111111111111111111111111111111111111111111